0 ,1659 ,1323 ,2982 ,,,,
1 ,1659 ,1323 ,2982 ,,,,
2 ,1659 ,1323 ,2982 ,,,,
3 ,1659 ,1323 ,2982 ,,,,
4 ,1659 ,1323 ,2982 ,,,,
5 ,1659 ,1323 ,2982 ,,,,
6 ,1659 ,1323 ,2982 ,,,,
7 ,1659 ,1323 ,2982 ,,,,
8 ,1659 ,1323 ,2982 ,,,,
9 ,1659 ,1323 ,2982 ,,,,
10 ,1659 ,1323 ,2982 ,,,,
11 ,1659 ,1323 ,2982 ,,,,
12 ,1659 ,1323 ,2982 ,,,,
13 ,1659 ,1323 ,2982 ,,,,
14 ,1659 ,1323 ,2982 ,,,,
15 ,1659 ,1323 ,2982 ,,,,
16 ,1659 ,1323 ,2982 ,,,,
17 ,1704 ,1344 ,3048 ,,,,
18 ,1749 ,1365 ,3114 ,,,,
19 ,1794 ,1386 ,3180 ,,,,
20 ,1839 ,1407 ,3246 ,,,,
21 ,2005 ,1530 ,3535 ,,,,
22 ,2171 ,1654 ,3825 ,,,,
23 ,2337 ,1778 ,4115 ,,,,
24 ,2503 ,1902 ,4405 ,,,,
25 ,2669 ,2026 ,4695 ,,,,
26 ,2835 ,2150 ,4985 ,,,,
27 ,3000 ,2274 ,5274 ,,,,
28 ,3166 ,2398 ,5564 ,,,,
29 ,3332 ,2522 ,5854 ,,,,
30 ,3498 ,2646 ,6144 ,,,,
31 ,3664 ,2769 ,6433 ,,,,
32 ,3830 ,2893 ,6723 ,,,,
33 ,3996 ,3017 ,7013 ,,,,
34 ,4162 ,3141 ,7303 ,,,,
35 ,4328 ,3265 ,7593 ,,,,
36 ,4494 ,3389 ,7883 ,,,,
37 ,4659 ,3513 ,8172 ,,,,
38 ,4825 ,3637 ,8462 ,,,,
39 ,4991 ,3761 ,8752 ,,,,
40 ,5157 ,3885 ,9042 ,,,,
41 ,5394 ,4066 ,9460 ,,,,
42 ,5632 ,4248 ,9880 ,,,,
43 ,5869 ,4429 ,10298 ,,,,
44 ,6106 ,4611 ,10717 ,,,,
45 ,6344 ,4793 ,11137 ,,,,
46 ,6581 ,4974 ,11555 ,,,,
47 ,6818 ,5156 ,11974 ,,,,
48 ,7056 ,5338 ,12394 ,,,,
49 ,7293 ,5519 ,12812 ,,,,
50 ,7530 ,5701 ,13231 ,,,,
51 ,7767 ,5883 ,13650 ,,,,
52 ,8005 ,6064 ,14069 ,,,,
53 ,8242 ,6246 ,14488 ,,,,
54 ,8479 ,6428 ,14907 ,,,,
55 ,8717 ,6609 ,15326 ,,,,
56 ,8954 ,6791 ,15745 ,,,,
57 ,9191 ,6973 ,16164 ,,,,
58 ,9429 ,7154 ,16583 ,,,,
59 ,9666 ,7336 ,17002 ,,,,
60 ,9903 ,7518 ,17421 ,,,,
61 ,10186 ,7763 ,17949 ,,,,
62 ,10468 ,8009 ,18477 ,,,,
63 ,10750 ,8255 ,19005 ,,,,
64 ,11033 ,8500 ,19533 ,,,,
65 ,11315 ,8746 ,20061 ,,,,
66 ,11598 ,8992 ,20590 ,,,,
67 ,11880 ,9237 ,21117 ,,,,
68 ,12163 ,9483 ,21646 ,,,,
69 ,12445 ,9729 ,22174 ,,,,
70 ,12728 ,9975 ,22703 ,,,,
71 ,13010 ,10220 ,23230 ,,,,
72 ,13293 ,10466 ,23759 ,,,,
73 ,13575 ,10712 ,24287 ,,,,
74 ,13857 ,10957 ,24814 ,,,,
75 ,14140 ,11203 ,25343 ,,,,
76 ,14422 ,11449 ,25871 ,,,,
77 ,14705 ,11694 ,26399 ,,,,
78 ,14987 ,11940 ,26927 ,,,,
79 ,15270 ,12186 ,27456 ,,,,
80 ,15552 ,12432 ,27984 ,,,,
81 ,15835 ,12677 ,28512 ,,,,
82 ,16117 ,12923 ,29040 ,,,,
83 ,16399 ,13169 ,29568 ,,,,
84 ,16682 ,13414 ,30096 ,,,,
85 ,16964 ,13660 ,30624 ,,,,
86 ,17247 ,13906 ,31153 ,,,,
87 ,17529 ,14151 ,31680 ,,,,
88 ,17812 ,14397 ,32209 ,,,,
89 ,18094 ,14643 ,32737 ,,,,
90 ,18377 ,14889 ,33266 ,,,,
91 ,18659 ,15134 ,33793 ,,,,
92 ,18942 ,15380 ,34322 ,,,,
93 ,19224 ,15626 ,34850 ,,,,
94 ,19506 ,15871 ,35377 ,,,,
95 ,19789 ,16117 ,35906 ,,,,
96 ,20071 ,16363 ,36434 ,,,,
97 ,20354 ,16608 ,36962 ,,,,
98 ,20636 ,16854 ,37490 ,,,,
99 ,20919 ,17100 ,38019 ,,,,
100 ,21201 ,17346 ,38547 ,,,,
101 ,21509 ,17623 ,39132 ,,,,
102 ,21816 ,17900 ,39716 ,,,,
103 ,22124 ,18177 ,40301 ,,,,
104 ,22432 ,18454 ,40886 ,,,,
105 ,22739 ,18732 ,41471 ,,,,
106 ,23047 ,19009 ,42056 ,,,,
107 ,23355 ,19286 ,42641 ,,,,
108 ,23662 ,19563 ,43225 ,,,,
109 ,23970 ,19840 ,43810 ,,,,
110 ,24278 ,20118 ,44396 ,,,,
111 ,24585 ,20395 ,44980 ,,,,
112 ,24893 ,20672 ,45565 ,,,,
113 ,25201 ,20949 ,46150 ,,,,
114 ,25508 ,21226 ,46734 ,,,,
115 ,25816 ,21504 ,47320 ,,,,
116 ,26124 ,21781 ,47905 ,,,,
117 ,26431 ,22058 ,48489 ,,,,
118 ,26739 ,22335 ,49074 ,,,,
119 ,27046 ,22612 ,49658 ,,,,
120 ,27354 ,22890 ,50244 ,,,,
121 ,27662 ,23167 ,50829 ,,,,
122 ,27969 ,23444 ,51413 ,,,,
123 ,28277 ,23721 ,51998 ,,,,
124 ,28585 ,23998 ,52583 ,,,,
125 ,28892 ,24276 ,53168 ,,,,
126 ,29200 ,24553 ,53753 ,,,,
127 ,29508 ,24830 ,54338 ,,,,
128 ,29815 ,25107 ,54922 ,,,,
129 ,30123 ,25384 ,55507 ,,,,
130 ,30431 ,25662 ,56093 ,,,,
131 ,30738 ,25939 ,56677 ,,,,
132 ,31046 ,26216 ,57262 ,,,,
133 ,31354 ,26493 ,57847 ,,,,
134 ,31661 ,26770 ,58431 ,,,,
135 ,31969 ,27048 ,59017 ,,,,
136 ,32277 ,27325 ,59602 ,,,,
137 ,32584 ,27602 ,60186 ,,,,
138 ,32892 ,27879 ,60771 ,,,,
139 ,33199 ,28156 ,61355 ,,,,
140 ,33507 ,28434 ,61941 ,,,,
141 ,33815 ,28711 ,62526 ,,,,
142 ,34122 ,28988 ,63110 ,,,,
143 ,34430 ,29265 ,63695 ,,,,
144 ,34738 ,29542 ,64280 ,,,,
145 ,35045 ,29820 ,64865 ,,,,
146 ,35353 ,30097 ,65450 ,,,,
147 ,35661 ,30374 ,66035 ,,,,
148 ,35968 ,30651 ,66619 ,,,,
149 ,36276 ,30928 ,67204 ,,,,
150 ,36584 ,31206 ,67790 ,,,,
151 ,36891 ,31483 ,68374 ,,,,
152 ,37199 ,31760 ,68959 ,,,,
153 ,37507 ,32037 ,69544 ,,,,
154 ,37814 ,32314 ,70128 ,,,,
155 ,38122 ,32592 ,70714 ,,,,
156 ,38430 ,32869 ,71299 ,,,,
157 ,38737 ,33146 ,71883 ,,,,
158 ,39045 ,33423 ,72468 ,,,,
159 ,39352 ,33700 ,73052 ,,,,
160 ,39660 ,33978 ,73638 ,,,,
161 ,39968 ,34255 ,74223 ,,,,
162 ,40275 ,34532 ,74807 ,,,,
163 ,40583 ,34809 ,75392 ,,,,
164 ,40891 ,35086 ,75977 ,,,,
165 ,41198 ,35364 ,76562 ,,,,
166 ,41506 ,35641 ,77147 ,,,,
167 ,41814 ,35918 ,77732 ,,,,
168 ,42121 ,36195 ,78316 ,,,,
169 ,42429 ,36472 ,78901 ,,,,
170 ,42737 ,36750 ,79487 ,,,,
171 ,43044 ,37027 ,80071 ,,,,
172 ,43352 ,37304 ,80656 ,,,,
173 ,43660 ,37581 ,81241 ,,,,
174 ,43967 ,37858 ,81825 ,,,,
175 ,44275 ,38136 ,82411 ,,,,
176 ,44583 ,38413 ,82996 ,,,,
177 ,44890 ,38690 ,83580 ,,,,
178 ,45198 ,38967 ,84165 ,,,,
179 ,45505 ,39244 ,84749 ,,,,
180 ,45813 ,39522 ,85335 ,,,,
181 ,46121 ,39799 ,85920 ,,,,
182 ,46428 ,40076 ,86504 ,,,,
183 ,46736 ,40353 ,87089 ,,,,
184 ,47044 ,40630 ,87674 ,,,,
185 ,47351 ,40908 ,88259 ,,,,
186 ,47659 ,41185 ,88844 ,,,,
187 ,47967 ,41462 ,89429 ,,,,
188 ,48274 ,41739 ,90013 ,,,,
189 ,48582 ,42016 ,90598 ,,,,
190 ,48890 ,42294 ,91184 ,,,,
191 ,49197 ,42571 ,91768 ,,,,
192 ,49505 ,42848 ,92353 ,,,,
193 ,49813 ,43125 ,92938 ,,,,
194 ,50120 ,43402 ,93522 ,,,,
195 ,50428 ,43680 ,94108 ,,,,
196 ,50736 ,43957 ,94693 ,,,,
197 ,51043 ,44234 ,95277 ,,,,
198 ,51351 ,44511 ,95862 ,,,,
199 ,51658 ,44788 ,96446 ,,,,
200 ,51966 ,45066 ,97032 ,,,,
220 ,58686 ,51345 ,110031 ,,,,
221 ,59022 ,51658 ,110680 ,,,,
